%%%%%%%
%.   .%
%%%.%%%
%  P  %
% %%% %
%  .%.%
%%%%%%%
